Abathur	t	Abathur
Servitore arciere	t	il servitore arciere
Segnalatore armata	t	il segnalatore armata
Segnalatore armata	t	il segnalatore armata
Arthas	t	Arthas
Locusta da assalto	t	la locusta da assalto
Segnalatore d'attacco	t	il segnalatore d'attacco
Segnalatore I.A. automatica	t	il segnalatore I.A. automatica
Banshee	t	la Banshee
Cuornero	t	Cuornero
Scatto della Tempesta	t	lo Scatto della Tempesta
Locusta da bombardamento	t	la locusta da bombardamento
Mazzetta	t	la mazzetta
Alachiara	t	Alachiara
Triboli	t	i triboli
Torre cannoniera	t	la Torre cannoniera
Capitan Cuornero	t	il capitan Cuornero
Servitore catapulta	t	il Servitore catapulta
Serpe delle Nubi	t	la Serpe delle Nubi
Obelisco della conduzione	t	l'obelisco della conduzione
Nucleo	t	il Nucleo
Teschio maledetto	t	il teschio maledetto
Servitore oscuro	t	il servitore oscuro
Rocce distruggibili	t	le rocce distruggibili
Baco Vorace	t	il Baco Vorace
Diablo	t	Diablo
Cane	t	il cane
Doblone	t	il doblone
Drago Cavaliere	t	il Drago Cavaliere
Altare del Drago	t	l'altare del Drago
Trivella Laser Drakken	t	la Trivella Laser Drakken
E.T.C.	t	E.T.C.
Ombra Divorante	t	l'Ombra Divorante
ETC	t	ETC
Falstad	t	Falstad
Servitore portabandiera	t	il servitore portabandiera
Fante	t	il fante
Servitore fante	t	il servitore fante
Forte	t	il Forte
Garage	t	il garage
Cancello	t	il Cancello
Sparachiodi	t	Sparachiodi
Nave Fantasma	t	la Nave Fantasma
Ghoul	t	il Ghoul
Golem delle Fosse	t	il Golem delle Fosse
Buco nel terreno	t	il buco nel terreno
Guardiano	t	il guardiano
Segno curativo	t	il segno curativo
Servitore guaritore	t	il servitore guaritore
Fonte curativa	t	la Fonte curativa
Placca curativa	t	la placca curativa
Scettro guaritore	t	lo scettro guaritore
Guardia Curativa	t	la Guardia Curativa
Blocco di Ghiaccio	t	il Blocco di Ghiaccio
Illidan	t	Illidan
Fortezza	t	la Fortezza
Kerrigan	t	Kerrigan
Cavaliere	t	il Cavaliere
Signora delle Spine	t	la Signora delle Spine
Li Li	t	Li Li
Re dei Lich	t	il Re dei Lich
Locusta	t	la Locusta
Sciame di Locuste	t	lo Sciame di Locuste
Luxoria - Scarabeo	t	Luxoria - Scarabeo
Malfurion	t	Malfurion
Meccatork	t	Meccatork
Servitore da mischia	t	il Servitore da mischia
Mengsk	t	Mengsk
Mina	t	la Mina
Condotto minerario	t	il Condotto minerario
Altare della Luna	t	l'altare della Luna
Granchio chiazzato	t	il granchio chiazzato
MULE	t	il MULE
Muradin	t	Muradin
Nazeebo	t	Nazeebo
Negromante	t	il negromante
Nova	t	Nova
Odin	t	l'Odin
Ogrodonte	t	l'ogrodonte
Ostruzione del percorso	t	l'ostruzione del percorso
Piaga dei Rospi	t	la Piaga dei Rospi
Regina Ombranera	t	la Regina Ombranera
Eroe casuale	t	l'eroe casuale
Corvo	t	il corvo
Signore dei Corvi	t	il Signore dei Corvi
Tributo del Signore dei Corvi	t	il Tributo del Signore dei Corvi
Spirito Vorace	t	lo Spirito Vorace
Raynor	t	Raynor
Bandito risorto	t	il bandito risorto
Guerriero risorto	t	il guerriero risorto
Torretta Spaccatutto	t	la Torretta Spaccatutto
Drone Esploratore	t	il Drone Esploratore
Sgt. Hammer	t	Sgt. Hammer
Gigante da Assedio	t	il Gigante da Assedio
Pirata scheletrico	t	il pirata scheletrico
Scheletro	t	lo Scheletro
Sonya	t	Sonya
Stregone	t	lo stregone
Regina delle Spore	t	la Regina delle Spore
Tritacarne	t	Tritacarne
Storm - Creatura	t	Storm - Creatura
Storm - Servitore	t	Storm - Servitore
Scheletro evocato	t	lo Scheletro evocato
Servitore evocatore	t	il servitore evocatore
Altare del Sole	t	l'altare del Sole
Simbionte	t	il Simbionte
Simulazione bersaglio	t	la simulazione bersaglio
Tassadar	t	Tassadar
Meccanista	t	Meccanista
Nido Tossico	t	il Nido Tossico
Treant	t	il Treant
Cassa del tesoro	t	la cassa del tesoro
Tychus	t	Tychus
Tyrael	t	Tyrael
Tyrande	t	Tyrande
Ultralisca	t	l'Ultralisca
Uther	t	Uther
Valla	t	Valla
Muro	t	il Muro
Maiale errante	t	il maiale errante
Torre di guardia	t	la Torre di guardia
Ragno Cadaverico dello Sciamano	t	il Ragno Cadaverico dello Sciamano
Gargantua dello Sciamano	t	il Gargantua dello Sciamano
Servitore mago	t	il servitore mago
Zeratul	t	Zeratul
Zombi	t	lo zombi
Campo di mercenari	t	il campo di mercenari
Campo di giganti da assedio	t	il campo di giganti da assedio
Campo del Drago	t	il campo del Drago
Campo di dobloni	t	il Campo di dobloni
Campo di cavalieri	t	il campo di cavalieri
Globo rigenerativo	t	il globo rigenerativo
Droide Riparatore	t	il Droide Riparatore
Campo respingente	t	il campo respingente
Vomide	t	il Vomide
Campo di combattenti	t	il Campo di combattenti
Campo di assediatori	t	il Campo di assediatori
Boss	t	il boss
Terrore Arboreo	t	il Terrore Arboreo
Servitore	t	il servitore
Servitori	t	i servitori
Mercenario	t	il mercenario
Mercenari	t	i mercenari
Scarafaggio	t	lo Scarafaggio
Scarafaggio Necroforo	t	lo Scarafaggio Necroforo
Sciame di Locuste - Insetto	t	lo Sciame di Locuste - Insetto
Legione di Scarafaggi	t	la Legione di Scarafaggi
Anub'arak	t	Anub'arak
Chen	t	Chen
Chen Terra	t	Chen Terra
Chen Tempesta	t	Chen Tempesta
Chen Fuoco	t	Chen Fuoco
Fosky	t	Fosky
Murloc	t	il murloc
Demone	t	il Demone
Portale Infernale	t	il Portale Infernale
Azmodan	t	Azmodan
Ritratto Billie la Capra Magica	t	il ritratto Billie la Capra Magica
Cavalcatura Tigre d'Oro	t	la cavalcatura Tigre d'Oro
Ritratto Tigre d'Oro	t	il ritratto Tigre d'Oro
Dono Reaper of Souls	t	il Dono Reaper of Souls
Kit del Fondatore	t	il Kit del Fondatore
Ritratto Celebrazione della Luna	t	il ritratto Celebrazione della Luna
Metalupo Mantoferreo	t	il Metalupo Mantoferreo
Ritratto eSports 2015	t	il ritratto eSports 2015
 Cavalcatura Carta di Hearthstone	t	la cavalcatura Carta di Hearthstone
Mascotte Golem delle Fosse	t	la mascotte Golem delle Fosse
Nido di Locuste	t	il Nido di Locuste
Mostruosità	t	la Mostruosità
Condotto minerario	t	il Condotto minerario
Idralisca	t	l'Idralisca
Baneling	t	il Baneling
Blatta	t	la Blatta
Mutalisca	t	la Mutalisca
Verme Nydus	t	il verme Nydus
Biotumore	t	il biotumore
Evocatore	t	l'evocatore
Soldato da Assedio	t	il soldato da Assedio
Uovo di Fosky	t	l'uovo di Fosky
Johanna	t	Johanna
Crociata	t	la Crociata
Jaina	t	Jaina
Elementale dell'Acqua	t	Elementale dell'Acqua
Kael'thas	t	Kael'thas
Thrall	t	Thrall
Totem dell'Esplosione di Fuoco	t	il Totem dell'Esplosione di Fuoco
Lupo Spirituale	t	il Lupo Spirituale
Wolf	t	il Lupo
Artanis	t	Artanis
Macellaio	t	il Macellaio
Grumo di Sangue	t	il Grumo di Sangue
Carne da Macello	t	Carne da Macello
Palo di Carne da Macello	t	il Palo di Carne da Macello
Leoric	t	Leoric
Rinnovamento Osseo	t	Rinnovamento Osseo
Sottrazione d'Essenza	t	Sottrazione d'Essenza
Olaf	t	Olaf
Erik	t	Erik
Baleog	t	Baleog
Vichinghi Sperduti	t	i Vichinghi Sperduti
I Vichinghi Sperduti	t	i Vichinghi Sperduti
Ten. Morales	t	il Ten. Morales
Navetta Medica da Sbarco	t	la Navetta Medica da Sbarco
Kharazim	t	Kharazim
Alleato curativo	t	l'alleato curativo
Alleato vigile	t	l'alleato vigile
Rexxar	t	Rexxar
Misha	t	Misha
Sylvanas	t	Sylvanas
Uther	t	Uther
Rehgar	t	Rehgar
Totem del Vincolo Terrestre	t	il Totem del Vincolo Terrestre
Guardia Sciamanica Curativa	t	la Guardia Sciamanica Curativa
Lungimiranza	t	la Lungimiranza
Zagara	t	Zagara
Spine Avvelenate	t	le Spine Avvelenate
Baneling	t	il Baneling
Biotumore	t	il Biotumore
Baco Vorace	t	il Baco Vorace
Idralisca	t	l'Idralisca
Verme Nydus	t	il Verme Nydus
Blatta	t	la Blatta
Manichino bersaglio	t	il manichino bersaglio
Manichino eroe bersaglio	t	il manichino eroe bersaglio
Manichino di copia	t	il manichino di copia
Manichino eroe bersaglio - David	t	il manichino eroe bersaglio - David
Manichino eroe bersaglio - Freddie	t	il manichino eroe bersaglio - Freddie
Manichino di cura eroe	t	il manichino di cura eroe
Nova	t	Nova
Tuta Efficiente	t	la Tuta Efficiente
Birra	t	la Birra
Goblin	t	il Goblin
Salute	t	la Salute
Mana	t	il Mana
Pupazzi di neve	t	i Pupazzi di neve
Furia	t	la Furia
Le forze del Nexus	t	le forze del Nexus
Torre cannoniera distrutta	t	la Torre cannoniera distrutta
Anziano Primate	t	l'Anziano Primate
Lunara	t	Lunara
Fuoco Fatuo	t	il Fuoco Fatuo
Fuochi Fatui	t	i Fuochi Fatui
Mantogrigio	t	Mantogrigio
Forma Worgen	t	la Forma Worgen
Ehi amico	t	Ehi amico
Capitan Cuornero	t	Capitan Cuornero
Cassa del tesoro	t	la Cassa del tesoro
Golem delle Sabbie	t	il Golem delle Sabbie
Lame di Azzinoth	t	le Lame di Azzinoth
Boss	t	il Boss
Terrore Arboreo	t	il Terrore Arboreo
Generatore di globi	t	il Generatore di globi
Servitore da mischia	t	il Servitore da mischia
Servitore da tiro	t	il Servitore da tiro
Servitore capo	t	il Servitore capo
Spira Mortale	t	la Spira Mortale
Spine Avvelenate	t	le Spine Avvelenate
Folata Gelida	t	la Folata Gelida
Scudo Antimagia	t	lo Scudo Antimagia
Bozzolo grande	t	il Bozzolo grande
Bozzolo normale	t	il Bozzolo normale
Ineluttabilità della Morte	t	l'Ineluttabilità della Morte
Fermezza Glaciale	t	la Fermezza Glaciale
Sindragosa	t	Sindragosa
Xul	t	Xul
Lancia d'Ossa	t	la Lancia d'Ossa
Scheletro Risorto	t	lo Scheletro Risorto
Mago Scheletrico	t	il Mago Scheletrico
Li-Ming	t	Li-Ming
Artefatto Xel'naga	t	l'Artefatto Xel'naga
Pezzo di Artefatto Xel'naga	t	il Pezzo di Artefatto Xel'naga
Aiutante	t	l'Aiutante
Intimidazione Primordiale	t	l'Intimidazione Primordiale
Presenza Imponente	t	la Presenza Imponente
Manichino bersaglio - Mercenario	t	il Manichino bersaglio - Mercenario
Manichino bersaglio - Mostro	t	il Manichino bersaglio - Mostro
Carne Fresca	t	la Carne Fresca
SCV	t	l'SCV
Nave da Sbarco SCV	t	la Nave da Sbarco SCV
Cuornero	t	Cuornero
Infatuazione	t	l'Infatuazione
Ala Offensiva	t	l'Ala Offensiva
Missione Segreta	t	la Missione Segreta
Piaga dei Rospi	t	la Piaga dei Rospi
Muro di Zombi	t	il Muro di Zombi
Combattente Elusivo	t	il Combattente Elusivo
Birra Purificatrice	t	la Birra Purificatrice
Presenza Infausta	t	la Presenza Infausta
Varco Infernale	t	il Varco Infernale
Potenziamento di Anime	t	il Potenziamento di Anime
Alleato dell'Aria	t	l'Alleato dell'Aria
Alleato della Terra	t	l'Alleato della Terra
Alleato Spiritico	t	l'Alleato Spiritico
Generatore di Scudo al Plasma	t	il Generatore di Scudo al Plasma
Palla di neve compatta	t	la palla di neve compatta
Palla di neve pesante	t	la palla di neve pesante
Minatore risorto	t	il Minatore risorto
Pozzo Lunare	t	il Pozzo Lunare
Torre	t	la torre
Campo di mercenari	t	il campo di mercenari
Energia	t	l'energia
Gallo	t	il gallo
Mago	t	il Mago
Torre di guardia	t	la Torre di guardia
Mutante	t	il Mutante
Acqua fresca	t	l'acqua fresca
Scarpe di lusso per polli	t	le scarpe di lusso per polli
Carburante per razzo	t	il carburante per razzo
Mangime speciale per polli	t	il mangime speciale per polli
Lingotto d'Oro	t	il lingotto d'oro
Gladiolo	t	il gladiolo
Petardo	t	il petardo
Moneta di giada	t	la moneta di giada
Uovo	t	l'uovo
Scudo di Nullificazione	t	lo Scudo di Nullificazione
Punitore	t	il Punitore
Tessitrice	t	la Tessitrice
Gargantua	t	il Gargantua
Treant	t	il Treant
Stendardo del campo	t	lo Stendardo del campo
Campo unità leggere	t	il Campo unità leggere
Globo rigenerante - Neutrale	t	il Globo rigenerante - Neutrale
Medikit	t	il Medikit
Generatore di Medikit	t	il Generatore di Medikit
Scatto della Tempesta	t	lo Scatto della Tempesta
Comunione Astrale	t	la Comunione Astrale
Missile	t	il Missile
Missile da assedio	t	il Missile da assedio
Mina Toro	t	la Mina Toro
Tritacarne Affamato	t	Tritacarne Affamato
Ira Ancestrale	t	l'Ira Ancestrale
Scudo Spiritico	t	lo Scudo Spiritico
Scatto del Vento	t	lo Scatto del Vento
Traslazione Gelida	t	la Traslazione Gelida
Manto del Re Morto	t	il Manto del Re Morto
Rinforzi	t	i Rinforzi
"Forziere"	t	il "Forziere"
Drago Spiritico	t	il Drago Spiritico
Manichino torretta	t	il Manichino torretta
Carico	t	il Carico
Teletrasporto	t	il Teletrasporto
Draghi Spiritici	t	i Draghi Spiritici
Pulsazione Curativa	t	la Pulsazione Curativa
Pulsazione Curativa	t	la Pulsazione Curativa
Sgherri	t	gli Sgherri
Sentinella	t	la Sentinella
Ingegnere	t	l'Ingegnere
Torretta	t	la Torretta
Destinazione finale del carico	t	la destinazione finale del carico
Campo di ricognizione	t	il Campo di ricognizione
Campo di supporto	t	il Campo di supporto
Campo fortificato	t	il Campo fortificato
Destinazione del carico	t	la destinazione del carico
Generatore di Medikit	t	il Generatore di Medikit
Checkpoint del carico	t	il Checkpoint del carico
Carico	t	il Carico
Medikit	t	il Medikit
Zucca	t	la Zucca
Forziere	t	il Forziere
Suolo Fertile	t	il Suolo Fertile
Grugny	t	Grugny
Protocollo Fantasma	t	il Protocollo Fantasma
Scaglie di Drago	t	le Scaglie di Drago
Arma del Bunker	t	l'Arma del Bunker
Groviglio di Cavi	t	il Groviglio di Cavi
Baneling a Ricerca	t	il Baneling a Ricerca
Scudo Elettromagnetico	t	lo Scudo Elettromagnetico
Lancia Baneling	t	il Lancia Baneling
Bunker PVE	t	il Bunker PVE
Seconda Possibilità	t	la Seconda Possibilità
Bocciolo a Ricerca	t	il Bocciolo a Ricerca
Allucinazione da Terrazine	t	l'Allucinazione da Terrazine
Fango Tossico	t	il Fango Tossico
Arma del Nucleo	t	l'Arma del Nucleo
Bozzolo di Ultralisca	t	il Bozzolo di Ultralisca
Arma del Nucleo Potenziata	t	l'Arma del Nucleo Potenziata
Tumore Vile	t	il Tumore Vile
Locusta	t	la Locusta
Regina delle Lame	t	La Regina delle Lame
Tritacarne Aberrazione	t	Tritacarne Aberrazione
Macellisca	t	la Macellisca
Rinforzi	t	i Rinforzi
Anubalisca	t	l'Anubalisca
Stukov Infestato	t	Stukov Infestato
Diablo Primordiale	t	Diablo Primordiale
Dehaka Alpha	t	Dehaka Alpha
Zagara Regina	t	Zagara Regina
Tychus Infestato	t	Tychus Infestato
Impulso Rinvigorente	t	l'Impulso Rinvigorente
Mini Testata Nucleare	t	la Mini Testata Nucleare
Stimpack di squadra	t	lo Stimpack di squadra
Emettitore Psionico	t	l'Emettitore Psionico
Cancello	t	il Cancello
Busta	t	la Busta
Petardo	t	il Petardo
Razzo Verde	t	il Razzo Verde
Servitore SCV	t	il ServitoreSCV
Archangel	t	l'Archangel
Mech infestati	t	i Mech infestati
Regina delle Lame	t	La Regina delle Lame
Scudo dell'Anima	t	lo Scudo dell'Anima
Grunt Demoniaco	t	il Grunt Demoniaco
Marine Alfa	t	il Marine Alfa
Seme	t	il Seme
Crisalide	t	la Crisalide
Zona Franca	t	la Zona Franca
Geniere del Cavaliere	t	il Geniere del Cavaliere
Geniere di Halloween	t	il Geniere di Halloween
Tributo	t	il Tributo
Immortale	t	l'Immortale
Mefisto	t	Mefisto
Titano delle Fosse Zombi	t	il Titano delle Fosse Zombi
Zombi Notturno	t	lo Zombi Notturno
Pianta della Crescita Infestante	t	la Pianta della Crescita Infestante
Sputaspine	t	lo Sputaspine
Combattenti	t	i Combattenti
Difensore del campo di prigionia	t	il Difensore del campo di prigionia
Mal'Ganis	t	Mal'Ganis
Piccolo Re	t	il Piccolo Re
Guerriero Demoniaco	t	il Guerriero Demoniaco
Imperius	t	Imperius
 
 
 
 
 
 
 
 
 
 
 
 
 
 
 
 
 
 
 
 
 
 
 
 
 
 
 
 
 
 
 
 
 
 
 
 
 
 
 
 
 
 
 
 
 
 
 
 
 
 
 
 
 
 
 
 
 
 
 
 
 
 
 
 
 
 
 
 
 
 
 
 
 
 
 
 
 
 
 
 
 
 
 
 
 
 
 
 
 
 
 
 
 
 
 
 
 
 
 
 
 
 
 
 
 
 
 
 
 
 
 
 
 
 
 
 
 
 
 
 
 
 
 
 
 
 
 
 
 
 
 
 
 
 
 
 
 
 
 
 
 
 
 
 
 
 
 
 
 
 
 
 
 
 
 
 
 
 
 
 
 
 
 
 
 
 
 
 
 
 
 
 
 
 
 
 
 
 
 
 
 
 
 
 
 
 
 
 
 
 
 
 
 
 
 
 
 
 
 
 
 
 
 
 
 
 
 
 
 
 
 
 
 
 
 
 
 
 
 
 
 
 
 
 
 
 
 
 
 
 
 
 
 
 
 
 
 
 
 
 
 
 
 
 
 
 
 
 
 
 
 
 
 
 
 
 
 
 
 
 
 
 
 
 
 
 
 
 
 
 
 
 
 
 
 
 
 
 
 
 
 
 
 
 
 
 
 
 
 
 
 
 
 
 
 
 
 
 
 
 
 
 
 
 
 
 
 
 
 
 
 
 
 
 
 
 
 
 
 
 
 
 
 
 
 
 
 
 
 
 
 
 
 
 
 
 
 
 
 
 
 
 
 
 
 
 
 
 
 
 
 
 
 
 
 
 
 
 
 
 
 
 
 
 
 
 
 
 
 
 
 
 
 
 
 
 
 
 
 
 
 
 
 
 
 
 
 
 
 
 
 
 
 
 
 
 
 
 
 
 
 
 
 
 
 
 
 
 
 
 
 
 
 
 
 
 
 
 
 
 
 
 
 
 
 
 
 
 
 
 
 
 
 
 
 
 
 
 
 
 
 
 
 
 
 
 
 
 
 
 
 
 
 
 
 
 
 
 
 
 
 
 
 
 
 
 
 
 
 
 
 
 
 
 
 
 
 
 
 
 
 
 
 
 
 
 
 
 
 
 
 
 
 
 
 
 
 
 
 
 
 
 
 
 
 
 
 
 
 
 
 
 
 
 
 
 
 
 
 
 
 
 
 
 
 
 
 
 
 
 
 
 
 
 
 
 
 
 
 
 
 
 
 
 
 
 
 
 
 
 
 
 
 
 
 
 
 
 
 
 
 
 
 
 
 
 
 
 
 
 
 
 
 
 
 
 
 
 
 
 
 
 
 
 
 
 
 
 
 
 
 
 
 
 
 
 
 
 
 
 
 
 
 
 
 
 
 
 
 
 
 
 
 
 
 
 
 
 
 
 
 
 
 
 
 
 
 
 
 
 
 
 
 
 
 
 
 
 
 
 
 
 
 
 
 
 
 
 
 
 
 
 
 
 
 
 
 
 
 
 
 
 
 
 
 
 
 
 
 
 
 
 
 
 
 
 
 
 
 
 
 
 
 
 
 
 
 
 
 
 
 
 
 
 
 
 
 
 
 
 
 
 
 
 
 
 
 
 
 
 
 
 
 
 
 
 
 
 
 
 
 
 
 
 
 
 
 
 
 
 
 
 
 
 
 
 
 
 
 
 
 
 
 
 
 
 
 
 
 
 
 
 
 
 
 
 
 
 
 
 
 
 
 
 
 
 
 
 
 
 
 
 
 
 
 
 
 
 
 
 
 
 
 
 
 
 
 
 
 
 
 
 
 
 
 
 
 
 
 
 
 
 
 
 
 
 
 
 
 
 
 
 
 
 
 
 
 
 
 
 
 
 
 
 
 
 
 
 
 
 
 
 
 
 
 
 
 
 
 
 
 
 
 
 
 
 
 
 
 
 
 
 
 
 
 
 
 
 
 
 
 
 
 
 
 
 
 
 
 
 
 
 
 
 
 
 
 
 
 
 
 
 
 
 
 
 
 
 
 
 
 
 
 
 
 
 
 
 
 
 
 
 
 
 
 
 
 
 
 
 
 
 
 
 
 
 
 
 
 
 
 
 
 
 
 
 
 
 
 
 
 
 
 
 
 
 
 
 
 
 
 
 
 
 
 
 
 
 
 
 
 
 
 
 
 
 
 
 
 
 
 
 
 
 
 
 
 
 
 
 
 
 
 
 
 
 
 
 
 
 
 
 
 
 
 
 
 
 
 
 
 
 
 
 
 
 
 
 
 
 
 
 
 
 
 
 
 
 
 
 
 
 
 
 
 
 
 
 
 
 
 
 
 
 
 
 
 
 
 
 
 
 
 
 
 
 
 
 
 
 
 
 
 
 
 
 
 
 
 
 
 
 
 
 
 
 
 
 
 
 
 
 
 
 
 
 
 
 
 
 
 
 
 
 
 
 
 
 
 
 
 
 
 
 
 
 
 
 
 
 
 
 
 
 
 
 
 
 
 
 
 
 
 
 
 
 
 
 
 
 
 
 
 
 
 
 
 
 
 
 
 
 
 
 
 
 
 
 
 
 
 
 
 
 
 
 
 
 
 
 
 
 
 
 
 
 
 
 
 
 
 
 
 
 
 
 
 
 
 
 
 
 
 
 
 
 
 
 
 
 
 
 
 
 
 
 
 
 
 
 
 
 
 
 
 
 
 
 
 
 
 
 
 
 
 
 
 
 
 
 
 
 
 
 
 
 
 
 
 
 
 
 
 
 
 
 
 
 
 
 
 
 
 
 
 
 
 
 
 
 
 
 
 
 
 
 
 
 
 
 
 
 
 
 
 
 
 
 
 
 
 
 
 
 
 
 
 
 
 
 
 
 
 
 
 
 
 
 
 
 
 
 
 
 
 
 
 
 
 
 
 
 
 
 
 
 
 
 
 
 
 
 
 
 
 
 
 
 
 
 
 
 
 
 
 
 
 
 
 
 
 
 
 
 
 
 
 
 
 
 
 
 
 
 
 
 
 
 
 
 
 
 
 
 
 
 
 
 
 
 
 
 
 
 
 
 
 
 
 
 
 
 
 
 
 
 
 
 
 
 
 
 
 
 
 
 
 
 
 
 
 
 
 
 
 
 
 
 
 
 
 
 
 
 
 
 
 
 
 
 
 
 
 
 
 
 
 
 
 
 
 
 
 
 
 
 
 
 
 
 
 
 
 
 
 
 
 
 
 
 
 
 
 
 
 
 
 
 
 
 
 
 
 
 
 
 
 
 
 
 
 
 
 
 
 
 
 
 
 
 
 
 
 
 
 
 
 
 
 
 
 
 
 
 
 
 
 
 
 
 
 
 
 
 
 
 
 
 
 
 
 
 
 
 
 
 
 
 
 
 
 
 
 
 
 
 
 
 
 
 
 
 
 
 
 
 
 
 
 
 
 
 
 
 
 
 
 
 
 
 
 
 
 
 
 
 
 
 
 
 
 
 
 
 
 
 
 
 
 
 
 
 
 
 
 
 
 
 
 
 
 
 
 
 
 
 
 
 
 
 
 
 
 
 
 
 
 
 
 
 
 
 
 
 
 
 
 
 
 
 
 
 
 
 
 
 
 
 
 
 
 
 
 
 
 
 
 
 
 
 
 
 
 
 
 
 
 
 
 
 
 
 
 
 
 
 
 
 
 
 
 
 
 
 
 
 
 
 
 
 
 
 
 
 
 
 
 
 
 
 
 
 
 
 
 
 
 
 
 
 
 
 
 
 
 
 
 
 
 
 
 
 
 
 
 
 
 
 
 
 
 
 
 
 
 
 
 
 
 
 
 
 
 
 
 
 
 
 
 
 
 
 
 
 
 
 
 
 
 
 
 
 
 
 
 
 
 
 
 
 
 
 
 
 
 
 
 
 
 
 
 
 
 
 
 
 
 
 
 
 
 
 
 
 
 
 
 
 
 
 
 
 
 
 
 
 
 
 
 
 
 
 
 
 
 
 
 
 
 
 
 
 
 
 
 
 
 
 
 
 
 
 
 
 
 
 
 
 
 
 
 
 
 
 
 
 
 
 
 
 
 
 
 
 
 
 
 
 
 
 
 
 
 
 
 
 
 
 
 
 
 
 
 
 
 
 
 
 
 
 
 
 
 
 
 
 
 
 
 
 
 
 
 
 
 
 
 
 
 
 
 
 
 
 
 
 
 
 
 
 
 
 
 
 
 
 
 
 
 
 
 
 
 
 
 
 
 
 
 
 
 
 
 
 
 
 
 
 
 
 
 
 
 
 
 
 
 
 
 
 
 
 
 
 
 
 
 
 
 
 
 
 
 
 
 
 
 
 
 
 
 
 
 
 
 
 
 
 
 
 
 
 
 
 
 
 
 
 
 
 
 
 
 
 
 
 
 
 
 
 
 
 
 
 
 
 
 
 
 
 
 
 
 
 
 
 
 
 
 
 
 
 
 
 
 
 
 
 
 
 
 
 
 
 
 
 
 
 
 
 
 
 
 
 
 
 
 
 
 
 
 
 
 
 
 
 
 
 
 
 
 
 
 
 
 
 
 
 
 
 
 
 
 
 
 
 
 
 
 
 
 
 
 
 
 
 
 
 
 
 
 
 
 
 
 
 
 
 
 
 
 
 
 
 
 
 
 
 
 
 
 
 
 
 
 
 
 
 
 
 
 
 
 
 
 
 
 
 
 
 
 
 
 
 
 
 
 
 
 
 
 
 
 
 
 
 
 
 
 
 
 
 
 
 
 
 
 
 
 
 
 
 
 
 
 
 
 
 
 
 
 
 
 
 
 
 
 
 
 
 
 
 
 
 
 
 
 
 
 
 
 
 
 
 
 
 
 
 
 
 
 
 
 
 
 
 
 
 
 
 
 
 
 
 
 
 
 
 
 
 
 
 
 
 
 
 
 
 
 
 
 
 
 
 
 
 
 
 
 
 
 
 
 
 
 
 
 
 
 
 
 
 
 
 
 
 
 
 
 
 
 
 
 
 
 
 
 
 
 
 
 
 
 
 
 
 
 
 
 
 
 
 
 
 
 
 
 
 
 
 
 
 
 
 
 
 
 
 
 
 
 
 
 
 
 
 
 
 
 
 
 
 
 
 
 
 
 
 
 
 
 
 
 
 
 
 
 
 
 
 
 
 
 
 
 
 
 
 
 
 
 
 
 
 
 
 
 
 
 
 
 
 
 
 
 
 
 
 
 
 
 
 
 
 
 
 
 
 
 
 
 
 
 
 
 
 
 
 
 
 
 
 
 
 
 
 
 
 
 
 
 
 
 
 
 
 
 
 
 
 
 
 
 
 
 
 
 
 
 
 
 
 
 
 
 
 
 
 
 
 
 
 
 
 
 
 
 
 
 
 
 
 
 
 
 
 
 
 
 
 
 
 
 
 
 
 
 
 
 
 
 
 
 
 
 
 
 
 
 
 
 
 
 
 
 
 
 
 
 
 
 
 
 
 
 
 
 
 
 
 
 
 
 
 
 
 
 
 
 
 
 
 
 
 
 
 
 
 
 
 
 
 
 
 
 
 
 
 
 
 
 
 
 
 
 
 
 
 
 
 
 
 
 
 
 
 
 
 
 
 
 
 
 
 
 
 
 
 
 
 
 
 
 
 
 
 
 
 
 
 
 
 
 
 
 
 
 
 
 
 
 
 
 
 
 
 
 
 
 
 
 
 
 
 
 
 
 
 
 
 
 
 
 
 
 
 
 
 
 
 
 
 
 
 
 
 
 
 
 
 
 
 
 
 
 
 
 
 
 
 
 
 
 
 
 
 
 
 
 
 
 
 
 
 
 
 
 
 
 
 
 
 
 
 
 
 
 
 