Archangel	t	l'Archangel
Baneling	t	il Baneling
Guardiano	t	il Guardiano
Idralisca	t	l'Idralisca
Mutalisca	t	la Mutalisca
Blatta	t	la Blatta
Archangel terran	t	l'Archangel terran
Ultralisca	t	l'Ultralisca
Zergling	t	lo Zergling
Dr. Cook	t	il Dr. Cook
Zerg alleati	t	gli Zerg alleati
Zerg nemici	t	gli Zerg nemici
Segnalatore	t	il Segnalatore
Boss	t	il Boss
Comandante	t	il Comandante
Sciame zerg	t	lo Sciame zerg
Goliath terran	t	il Goliath terran
Hellbat terran	t	l'Hellbat terran
Raven terran	t	il Raven terran
Bunker	t	il Bunker
Goliath	t	il Goliath
Hellbat	t	l'Hellbat
Marine	t	il Marine
Raven	t	il Raven
Gioco Arcade	t	il Gioco Arcade
Campo di combattenti	t	il Campo di combattenti
Campo di assediatori	t	il Campo di assediatori
Bunker migliorato	t	il Bunker migliorato
Zerg Blu	t	gli Zerg Blu
Zerg Rossi	t	gli Zerg Rossi
Grugny	t	Grugny
Protocollo Fantasma	t	il Protocollo Fantasma
Scaglie di Drago	t	le Scaglie di Drago
Arma del Bunker	t	l'Arma del Bunker
Groviglio di Cavi	t	il Groviglio di Cavi
Baneling a Ricerca	t	il Baneling a Ricerca
Scudo Elettromagnetico	t	lo Scudo Elettromagnetico
Lancia Baneling	t	il Lancia Baneling
Bunker PVE	t	il Bunker PVE
Seconda Possibilità	t	la Seconda Possibilità
Bocciolo a Ricerca	t	il Bocciolo a Ricerca
Allucinazione da Terrazine	t	l'Allucinazione da Terrazine
Fango Tossico	t	il Fango Tossico
Arma del Nucleo	t	l'Arma del Nucleo
Bozzolo di Ultralisca	t	il Bozzolo di Ultralisca
Arma del Nucleo Potenziata	t	l'Arma del Nucleo Potenziata
Tumore Vile	t	il Tumore Vile
Locusta	t	la Locusta
Regina delle Lame	t	la Regina delle Lame
Tritacarne Aberrazione	t	Tritacarne Aberrazione
Macellisca	t	la Macellisca
Rinforzi	t	i Rinforzi
Anubalisca	t	l'Anubalisca
Stukov Infestato	t	Stukov Infestato
Diablo Primordiale	t	Diablo Primordiale
Dehaka Alpha	t	Dehaka Alpha
Zagara Regina	t	Zagara Regina
Tychus Infestato	t	Tychus Infestato
Impulso Rinvigorente	t	l'Impulso Rinvigorente
Mini Testata Nucleare	t	la Mini Testata Nucleare
Stimpack di squadra	t	lo Stimpack di squadra
Emettitore Psionico	t	l'Emettitore Psionico
Cancello	t	il Cancello