Cassa di bombe	t	la cassa di bombe
Casse di bombe	t	le casse di bombe
Zombi Titano delle Fosse	t	lo Zombi Titano delle Fosse
Zombi Titani delle Fosse	t	gli Zombi Titani delle Fosse
Avatar del Negromante	t	l'Avatar del Negromante
Segnale di conquista città neutrale	t	il segnale di conquista città neutrale
Segnali di conquista città neutrale	t	i segnali di conquista città neutrale
Zombi Notturno	t	lo Zombi Notturno
Zombi Notturni	t	gli Zombi Notturni
Avatar del Signore dei Corvi	t	l'Avatar del Signore dei Corvi
Guaritrice Spiritica	t	la Guaritrice Spiritica
Guaritrici Spiritiche	t	le Guaritrici Spiritiche
Sputaspine	t	lo Sputaspine
Sputaspine	t	gli Sputaspine
Veicolo Titano delle Fosse	t	il Veicolo Titano delle Fosse
Entrata del tunnel	t	l'entrata del tunnel
Uscita del tunnel	t	l'uscita del tunnel
Cavaliere Senza Testa	t	il Cavaliere Senza Testa
Falegnameria	t	la falegnameria
Fonderia	t	la fonderia
Cimitero	t	il cimitero
Miniera	t	la miniera
Armeria	t	l'armeria
Fattoria	t	la fattoria
Geniere	t	il Geniere
Altare	t	l'Altare
Geniere	t	il Geniere
Cavaliere senza Testa	t	il Cavaliere senza Testa
Genieri	t	i Genieri
Mercenario - Geniere Goblin difensore	t	il Mercenario - Geniere Goblin difensore
Mercenario - Cavaliere difensore	t	il Mercenario - Cavaliere difensore
Cavaliere assaltatore	t	il Cavaliere assaltatore
Testa del Cavaliere	t	la testa del Cavaliere
Cavaliere	t	il Cavaliere
Ostruzione del percorso (Muro TdR)	t	l'ostruzione del percorso (Muro TdR)
Forziere dei Draghi	t	il Forziere dei Draghi
Forziere del Drone	t	il Forziere del Drone
Draghi Spiritici	t	i Draghi Spiritici
Drone Esploratore	t	il Drone Esploratore
Zucca	t	la Zucca
Titano delle Fosse Zombi	t	il Titano delle Fosse Zombi
Zombi Notturno	t	lo Zombi Notturno